**************************************************
*******                              ******** ****
******* ************** ************* ******** ****
******* ************** ***         * ***      ****
S       ************** **  ******* * *** **** ****
******* ***         ** *  *******        **** ****
******* *** ******* ** * ******************** ****
******* *** ******* **   ******************** ****
******* *** ******* ************************* ****
******* *** **                      ********* ****
***     *** ** **** **** ******************** ****
*** ********** **** ****              ******* ****
*** ********** **** ************************* ****
*** ********** **** ************************* ****
***            **** *************** ********* ****
******** ********** *************** ********* ****
******** ********** ***************      **** ****
********      ***** ***************  *** **** ****
*******************                  ******** ****
************************************ ******** ****
************************************ *************
************************************             F
**************************************************